3 13 31
###############################
#p    *s*** x  *   *1    *   *#
# # # # #*# # #*#*# # # # # # #
#   *    ***** * ***    4     #
# # #*# # # #*# #*# #*#*# #*# #
#   *   *     ****  ****   3  #
# # # # # # # # # # # # #*# #*#
#      **     *4       * * 5  #
# # # # # # # # # # # # #*#*# #
#       *     *  * 2**     *  #
# #*# # # # # # #*# # # # #*# #
#      *  *   2 *1      *  *  #
###############################
