2 13 31
###############################
#p    *s***    *   *1    *   *#
# # # # #*# # #*#*# # # # # # #
#   *    ***** * ***          #
# # #*# # # #*# #*# #*#*# #*# #
#   *     3   ****  ****   2  #
# # # # # # # # # # # # #*# #*#
#      * *       3      * * 1 #
# # # # # # # # # # # # #*#*# #
#    x  *     *  * 2**     *  #
# #*# # # # # # #*# # # # #*# #
#      *  *   2 *1      *  *  #
###############################
