4 13 31
###############################
#p    *s***    *3  *     *   *#
# # # # #*# # #*#*# # # # # # #
#   *   3***** * ***          #
# # #*# # # #*#1#*# #*#*# #*#2#
#   *   *     ****  ****      #
# # # # # # # # # # # # #*# #*#
#   x  **   4 *        * *    #
# # # # # # # # # # # # #*#*# #
#   2   *     *  *  **     *  #
# #*# # # # # # #*# # #5# #*# #
#      *  *     *       *  *  #
###############################
