7 13 31
###############################
#p    *s***    *   *1    *   *#
# # # # #*# # #*#*# # # # # # #
#   *    ***** * ***    4     #
# # #*# # # #*# #*# #*#*# #*# #
#   *   *  2  ****  ****   3  #
# # # # # # # # # # # # #*# #*#
#      **     *4       * * 5  #
# # # # # # #*# # # # # #*#*# #
#       *  **x*  * 3**     *  #
# #*# # # # #5# #*# # # # #*# #
#  3   *  *     *       *  *  #
###############################
