5 13 31
###############################
#p    *****    *   *1    *   *#
# # # #5#*# # #*#*# # # # # # #
#   *    ***** * ***    5     #
# # #s# # # #*# #*# #*#*# #*# #
#   *   *     ****  ****      #
# #b# # #2# # # # # # # #*# #*#
#      **     *        * *    #
# # # # # # # # # # # # #*#*# #
#       *     *  * 1**     *  #
# #*# # # # # # #*# # # # #*#3#
#  3   *  *     *4      *  * x#
###############################
