2 13 31
###############################
#p    * ***    *   *1    *   *#
# # # # #*# # #*#*# # # # # # #
#   *    ***** * ***          #
# # #*# # # #*# #*# #*#*# #*# #
#   *         ****  ****   2  #
# # # # # # # # # # # # #*# #*#
#                1      * * 1 #
# # # # # # # # # # # # #*#*# #
#       *     *  * 2**     *  #
# #*# # # # # # #*# # # # #*# #
#      *  *   2 *1      *  *  #
###############################
